11111111111111111111
100P011111001C00C001
11000E0010000C00E001
1010C00000C010C01001
10C00000010000000101
1010000C010000000001
11111111111111111111