11111111111111111111
1CP0111111001X0000C1
11000C0010000X00C001
1010000X000010X01001
10X00000010000000101
1010000XC1000E0C0001
11111111111111111111